NO ./textures/aalleon256.xpm
SO ./textures/jbouyer256.xpm
WE ./textures/alefranc256.xpm
EA ./textures/lmarecha256.xpm

F 200,200,200
C 255,255,255
11111111111111111111111111111111111111111111111111111111111111111111111111111111111111111111111111111111111111111111111111111111111111111111111111111111111111111111111111111111111
10000000000000000000000000000000000000000000000000000000000000000000000000000000000000000000000000000000000000000000000000000000000000000000000000000000000000000000000000000000001
10000000000000000000000000000000000000000000000000000000000000000000000000000000000000000000000000000000000000000000000000000000000000000000000000000000000000000000000000000000001
10000000000000000011111111100000000111111111111111111000000000000000000000000111111111000000001111111111111111110000000000000000000000001111111110000000011111111111111111100000001
10000000000000000011111111000000000111111111111111111000000000000000000000000111111110000000001111111111111111110000000000000000000000001111111100000000011111111111111111100000001
10000000000000000111111110000000000111100000111111111000000000000000000000001111111100000000001111000001111111110000000000000000000000011111111000000000011110000011111111100000001
10000000000000001111111100000000000110000000111111111000000000000000000000011111111000000000001100000001111111110000000000000000000000111111110000000000011000000011111111100000001
10000000000000011111111000000000000100000000111111111000000000000000000000111111110000000000001000000001111111110000000000000000000001111111100000000000010000000011111111100000001
10000000000000111111110000000000000000000000111111111000000000000000000001111111100000000000000000000001111111110000000000000000000011111111000000000000000000000011111111100000001
10000000000001111111100000000000000000000001111111110000000000000000000011111111000000000000000000000011111111100000000000000000000111111110000000000000000000000111111111000000001
10000000000011111111000000000000000000000011111111100000000000000000000111111110000000000000000000000111111111000000000000000000001111111100000000000000000000001111111110000000001
10000000000111111110000000000000000000000111111111000000000000000000001111111100000000000000000000001111111110000000000000000000011111111000000000000000000000011111111100000000001
10000000001111111100000000000000000000001111111100000000000000000000011111111000000000000000000000011111111000000000000000000000111111110000000000000000000000111111110000000000001
10000000011111111000000000000000000000011111111000000000000000000000111111110000000000000000000000111111110000000000000000000001111111100000000000000000000001111111100000000000001
10000000111111110000000000000000000000111111110000000000000000000001111111100000000000000000000001111111100000000000000000000011111111000000000000000000000011111111000000000000001
10000001111111100000000000000000000001111111100000000000000000000011111111000000000000000000000011111111000000000000000000000111111110000000000000000000000111111110000000000000001
10000011111111000000000000000000000011111111100000000000000000000111111110000000000000000000000111111111000000000000000000001111111100000000000000000000001111111110000000000000001
10000111111111111111111111111111100111111111000000000000000000001111111111111111111111111111001111111110000000000000000000011111111111111111111111111110011111111100000000000000001
10001111111111111111111111111111100111111111100000000000100000011111111111111111111111111111001111111111000000000001000000111111111111111111111111111110011111111110000000000010001
10001111111111111111111111111111100111111111100000000001100000011111111111111111111111111111001111111111000000000011000000111111111111111111111111111110011111111110000000000110001
10000000000000000000000001111111100111111111100000000011100000000000000000000000000011111111001111111111000000000111000000000000000000000000000111111110011111111110000000001110001
10000000000000000000000001111111100111111111100000000111100000000000000000000000000011111111001111111111000000001111000000000000000000000000000111111110011111111110000000011110001
10000000000000000000000001111111100111111111111111111111100000000000000000000000000011111111001111111111111111111111000000000000000000000000000111111110011111111111111111111110001
10000000000000000000000001111111100111111111111111111111100000000000000000000000000011111111001111111111111111111111000000000000000000000000000111111110011111111111111111111110001
10000000000000000000000000000000000000000000000000000000000000000000000000000000000000000000000000000000000000000000000000000000000000000000000000000000000000000000000000000000001
10000000000000000000000000000000000000000000000000000000000000000000000000000000000000000000000000000000000000000000000000000000000000000000000000000000000000000000000000000000001
10000000000000000000000000000000000000000000000000000000000000000000000000000000000000000000000000000000000000000000000000000000000000000000000000000000000000000000000000000000001
10000000000000000000000000000000000000000000000000000000000000000000000000000000000000000000000000000000000000000000000000000000000000000000000000000000000000000000000000000000001
10000000000000000011111111100000000111111111111111111000000000000000000000000111111111000000001111111111111111110000000000000000000000001111111110000000011111111111111111100000001
10000000000000000011111111000000000111111111111111111000000000000000000000000111111110000000001111111111111111110000000000000000000000001111111100000000011111111111111111100000001
10000000000000000111111110000000000111100000111111111000000000000000000000001111111100000000001111000001111111110000000000000000000000011111111000000000011110000011111111100000001
1000000000000000111111110000000000011000000011111111100000000000000000000001111111100000000000110000000111111111000000N000000000000000111111110000000000011000000011111111100000001
10000000000000011111111000000000000100000000111111111000000000000000000000111111110000000000001000000001111111110000000000000000000001111111100000000000010000000011111111100000001
10000000000000111111110000000000000000000000111111111000000000000000000001111111100000000000000000000001111111110000000000000000000011111111000000000000000000000011111111100000001
10000000000001111111100000000000000000000001111111110000000000000000000011111111000000000000000000000011111111100000000000000000000111111110000000000000000000000111111111000000001
10000000000011111111000000000000000000000011111111100000000000000000000111111110000000000000000000000111111111000000000000000000001111111100000000000000000000001111111110000000001
10000000000111111110000000000000000000000111111111000000000000000000001111111100000000000000000000001111111110000000000000000000011111111000000000000000000000011111111100000000001
10000000001111111100000000000000000000001111111100000000000000000000011111111000000000000000000000011111111000000000000000000000111111110000000000000000000000111111110000000000001
10000000011111111000000000000000000000011111111000000000000000000000111111110000000000000000000000111111110000000000000000000001111111100000000000000000000001111111100000000000001
10000000111111110000000000000000000000111111110000000000000000000001111111100000000000000000000001111111100000000000000000000011111111000000000000000000000011111111000000000000001
10000001111111100000000000000000000001111111100000000000000000000011111111000000000000000000000011111111000000000000000000000111111110000000000000000000000111111110000000000000001
10000011111111000000000000000000000011111111100000000000000000000111111110000000000000000000000111111111000000000000000000001111111100000000000000000000001111111110000000000000001
10000111111111111111111111111111100111111111000000000000000000001111111111111111111111111111001111111110000000000000000000011111111111111111111111111110011111111100000000000000001
10001111111111111111111111111111100111111111100000000000100000011111111111111111111111111111001111111111000000000001000000111111111111111111111111111110011111111110000000000010001
10001111111111111111111111111111100111111111100000000001100000011111111111111111111111111111001111111111000000000011000000111111111111111111111111111110011111111110000000000110001
10000000000000000000000001111111100111111111100000000011100000000000000000000000000011111111001111111111000000000111000000000000000000000000000111111110011111111110000000001110001
10000000000000000000000001111111100111111111100000000111100000000000000000000000000011111111001111111111000000001111000000000000000000000000000111111110011111111110000000011110001
10000000000000000000000001111111100111111111111111111111100000000000000000000000000011111111001111111111111111111111000000000000000000000000000111111110011111111111111111111110001
10000000000000000000000001111111100111111111111111111111100000000000000000000000000011111111001111111111111111111111000000000000000000000000000111111110011111111111111111111110001
10000000000000000000000000000000000000000000000000000000000000000000000000000000000000000000000000000000000000000000000000000000000000000000000000000000000000000000000000000000001
10000000000000000000000000000000000000000000000000000000000000000000000000000000000000000000000000000000000000000000000000000000000000000000000000000000000000000000000000000000001
11111111111111111111111111111111111111111111111111111111111111111111111111111111111111111111111111111111111111111111111111111111111111111111111111111111111111111111111111111111111
