NO /sgoinfre/goinfre/Perso/aalleon/evaluator.xpm
SO /sgoinfre/goinfre/Perso/aalleon/evaluator.xpm
WE /sgoinfre/goinfre/Perso/aalleon/evaluator.xpm
EA /sgoinfre/goinfre/Perso/aalleon/evaluator.xpm

F 255,0,255
C 0,255,0

1111111111111111111111
1111111100000111111111
1111110000000001111111
1111100000000000111111
1111000000000W00011111
1111100000000000111111
1111110000000001111111
1111111100000111111111
1111111111111111111111
