NO ./textures/aalleon256.xpm
SO ./textures/jbouyer256.xpm
WE ./textures/alefranc256.xpm
EA ./textures/lmarecha256.xpm

F 200,200,200
C 255,255,255
1111111111111111111111111111111111111111111111111111111111111
1000000000000000000000000000000000000000000000000000000000001
1111111100000000000000000000000000000000000000000000001111111
       100000000000000000000000000000000000000000000001
1111111100000000001111111100000000011111111111100000001111111
1000000000000000011111111000000000011110000011111000000000001
1000000000000000111111110000000000011000000011111111111111111
10000000000000011111111000000000000100000000111
10000000000000111111110000000000000000000000001
10000000000001111111100000000000000000000001111
1000000000001111111100000000000000000000001111111111111111111
100000000001111111100000000000N000000000011111111100000000001
1000000000111111110000000000000000000000111111110000000000001
1000000001111111100000000000000000000000000000000000000000001
1000000011111111000000000000000000000000000000000000000000001
1000000111111110000000000000000000000111111110000000000000001
1000001111111100000000000000000000001111111110000000000000001
1000011111111111111111111111111110011111111100000000000000001
1000111111111111111111111111111110011111111110000000000010001
1000111111111111111111111111111111111111111111000000001100001
10000000000000000000001                       100000000000001
10000000000000000000001                       100000000000001
10000000000000000000001                       100000000000001
10000000000000000000001                       100000000000001
10000000000000000000001                       100000000000001
10000000000000000000001                       100000000000001
11111111111111111111111                       111111111111111
