
     NO ./textures/aalleon256.xpm

SO ./textures/jbouyer256.xpm
       WE ./textures/aalleon256.xpm






   EA ./textures/jbouyer256.xpm

F 255,255,0

C 255,0,255

111111111
100000001
10000E001
100000001
100000001
111111111


        1111111111111111111111111
1000000000110000000000001
1011000001110000000000001
       1001000000000000000000001
111111111011000001110000000000001
1000000000111111111111111111111111
111101110               11111011100000010001
11110111111111011101010010001
11000000110101011100000010001
10000000000000001100000010001
10000000000000001101010010001
11000001110101011111011110N0111
11110111 1110101 101111010001
11111111 1111111 111111111111
