NO ./textures/aalleon256.xpm
SO ./textures/jbouyer256.xpm
WE ./textures/alefranc256.xpm
EA ./textures/lmarecha256.xpm

F 200,200,200
C 255,255,255

1111111111111111111111111111
1000000000000000000000000001
1000000000001000000000000001
10000000010101010000000000001
10000000101000101000000000001
10000001111111111111110000011111
1000000000000000000000000001
100000000000000000N000000001
1000111111111100000000000001
1000000011111100000000000001
1000000000111100000000000001
1000000000000000000000000001
1111111111111111111111111111
